1111111111111111111
1E1E1E1E1E1E1E1E1E1
11E1E1E1E1E1E1E1E11
1E1E1E1E1E1E1E1E1E1
11E1E1E1E1E1E1E1E11
1E1E1E1E1E1E1E1E1E1
11E1E1E1E1E1E1E1E11
1E1E1E1E1E1E1E1E1E1
11E1E1E1E1E1E1E1E11
1E1E1E1E1E1E1E1E1E1
11E1E1E1E1E1E1E1E11
1E1E1E1E1E1E1E1E1E1
11E1E1E1E1E1E1E1E11
1E1E1E1E1E1E1E1E1E1
11E1E1E1E1E1E1E1E11
1E1E1E1E1E1E1E1E1E1
11E1E1E1E1E1E1E1E11
1111111111111111111
1PCX1000000000000E1
1111111111111111111